2***@8**X@*****
****@@@@@@@@@@@
*3**@3**4@****5
@@@@@@@@@@@@@@@
****@***6@*****
****@5***@****7
6**7@***4@**8**
@@@@@@@@@@@@@@@
***0@****@****0
****@****@*****
****@****@2****