5@*****@*****@*****X
*@*****@*****@******
*@***6*@*****@******
*@5***9@7***6@******
*@@@@@@@@@@@@@******
****4@*******@******
*****@**@****@******
*****@2*@****@*****9
@@@@@@@@@@@@@@@@@@@@
**0**@******4@0*****
*****@*******@******
2*0*3@3******@******
@@@@@@@@@@@@@@@@@@@@
****0@*******@7*****
*****@8******@*****8