*******************X
**@@@@@@@@@@@@@@@@@@
********************
********************
********************
********************
********************
********************
********************
********************
********************
********************
********************
********************
********************