@******@@@****X
@****@@@@@@@*@*
@****@***@***@*
*@@@@@@@*****@*
*********@@@@@@