*******@3*****4
*******@@@@@@@@
*******@******5
2*****3@4***@@@
@@@@@@@@@@@@@@@
*******@*******
*******0***2**@
*******@******@
*******@@@@@@@@
*******@5@***0@
*******@X@****@