********************
5*******************
******@@@@@@***X****
@@@@@@@5432@@@@@@@@@
********************
***********@@@@@@@@*
*******@***@@@@@@@@*
*@@@@@4@***@@*******
******@@***@@*******
*@*********@@*******
*3@@*******@@0******
@@@@@@@@@@@@@@@@@@@@
********************
***@@@@***@@@@@@@@@@
*****2@************0